黑布香囊	Scented Sachet
甲乙囊	Eastern Bag
野猪皮香囊	Scented Sachet
莲花斩仙囊	Lotus Flower Immortal Slaying Bag
兔皮香囊	Scented Sachet
戊己灵骨囊	Central Spirit Bone Bag
狼皮香囊	Scented Sachet
行疆炽魂囊	Trekking Flame Spirit Bag
熊皮薄下裳	Thin Pants
行疆霓光御	Trekking Neon Light  Robe
蓝布薄下裳	Thin Pants
甲乙道德衫	Eastern Moral  Robe
镇岳圣囊	Hill Fall Sagely Bag
野猪皮薄下裳	Thin Pants
戊己三才御	Central Three Talents  Armor
蓝布香囊	Scented Sachet
苍莽天地囊	Colossal Heaven and Earth Bag
四象甲	The Four Statues  Shirt
靛蓝布手帕	Handkerchief
长生恶魄帛	Longevity Evil Soul  Silk
紫布手帕	Handkerchief
苍莽辟邪帛	Colossal Evil Deterring  Textile
青龙三清绢	Azuragon Triple Purity  Silk
白布手帕	Handkerchief
苍龙白骨绢	Marinagon White Bone  Silk
