妖韧皮休闲衣衫	Tough Demon Hide Casual Shirt
妖韧皮修行下裳	Tough Demon Hide Cultivator Pants
灵晶锤	Spirit Crystal Mace
灵木	Spiritwood
降龙万象柱	Dragon Vanquishing All Phenomena Wood
神珀符	Sacred Talisman
苍莽流星符	Colossal Falling Star  Incantation
面粉	Flour
坤元冲虚散	Earthbound Facing the Void  Bag
可以大幅提高炎热抵抗的符咒。	Talisman used to drastically raise resistance to heat.
太阴符	Talisman of Supreme Yin
可以提高身体自然恢复力的符咒。	Talisman used to raise natural recovery rate.
药师祛病符	Talisman of Curer
佩戴者可以从根本上提高法术威力，法术灵气消耗。	Fundamentally increases the wearer's Spell Power and Qi Cost.
圣咒符	Sacredcurse Talisman
角色出生点	
逻辑点	
造化灵池	Destiny Pool
葛	Ge
东霞	
朋	Peng
沃	Wo
咏	Yong
党	Dang
军	Jun
最后的旅行者	Last Traveller
大日流光咒	
紫薇镇神真言	
壬癸镇神神雷	
乐梦柏上仙金刚诀	
本源陨星咒	
在世界开始灭亡后，我便开始环游世界，已经几十年没见过活人了……想不到在这最后之地，竟然还能遇到一名外来者共同见证。	After the start of the world's destruction I began to travel around the world, and haven't seen any livings for decades... It was out of my expectation to have you to watch all things here, the ending place.
也好，观世界破时，我领悟五行辟易之道。就在这生命的最后与你做个验证吧！	Not bad, I have some comprehension of the five elements turning when watch the oblivion of the world. Let me test that on you now, which is the end of my life, or your life!
