妖韧皮修行衣衫	Tough Demon Hide Sect Uniform
妖韧皮薄下裳	Tough Demon Hide Thin Pants
梧桐木刀	Parasol Wood Blade
天龙砂	Dragon Feces
镇岳异骨粪	Hill Fall Unusual Bone  Dung
红布	Red Fabric
苍莽庇世帛	Colossal Secluded  Gauze
让人心情轻微变好，且降低娱乐值的衰减速度。	Talisman used to improve mood and reduce entertainment need.
长乐符	Talisman of Lasting Joy
佩戴者可以从根本上降低术法技能灵气消耗。	Fundamentally decreases the wearer's Qi Cost of Spells.
灵咒符	Spiritcurse Talisman
佩戴者可以从根本上提高法宝威力，并全面提高法宝能力。	Fundamentally increases the wearer's Artifact Power, and comprehensively improves Artifact abilities.
圣剑符	Sacredsword Talisman
蜚皮休闲衣衫	Fei Hide Casual Shirt
蜚皮薄下裳	Fei Hide Thin Pants
巧夺天工的神兵，融合制作者的心血与灵感而成。	
震山河	Ice Essence Spear
木刀	Blade
五云七魄刀	Five Clouds Seven Souls Blade
棉花	Cotton
甲乙千魂线	Eastern Thousand Souls Thread
佩戴者可以提高抵御水属性伤害之力。	Increases the wearer's resistance to Water Damage.
水甲符	Waterarmor Talisman
佩戴者可以提高神民上限。	Increases Max Divine Residents limit for the wearer.
神居符	Talisman of Divine Residence
佩戴者可以提高寿元，远离疾瘴。恭祝各位新春快乐，万事如意！	Used to raise lifespan and immunity to diseases for whomever wears it. Happy Spring Festival and all the best!
万寿图	Illustration of Everlasting Longevity
蜚皮休闲下裳	Fei Hide Casual Pants
寒晶弓	Ice Crystal Bow
紫布薄下裳	Thin Pants
长生白骨御	Longevity White Bone Clothes
金丝木料	Goldwood Timber
苍龙七魄木	Marinagon Seven Souls  Take
棕石砖	Brownstone Block
戊土五色碑	Grim Prismatic  Tower
可以提高视野范围，并提高历练时发现新地点的速度。	Talisman used to improve range of views, and reduce time spent discovering a new location in adventure.
千里神视符	Talisman of Foreseer
提高战斗能力，提高疼痛忍耐。	Used to improve fighting abilities and pain endurance.
武昌符	Talisman of Military Prosperity
提高饮气辟谷的效率。	Used to raise efficiency of Qi absorption and fasting.
饮气符	Talisman of Qi Absorption
鹿蜀皮薄衣衫	Lushu Hide Thin Shirt
鹿蜀皮薄下裳	Lushu Hide Thin Pants
玄铁锤	Darksteel Mace
灰石	Graystone
腾岳涤心印	Hill Rise Clean Mind Stone
牛皮薄衣衫	Thin Shirt
坤元千魂衫	Earthbound Thousand Souls  Shirt
佩戴者可以提高抵御火属性伤害之力。	Increases the wearer's resistance to Fire Damage.
火甲符	Firearmor Talisman
可以提高突破瓶颈的概率。	Used to raise the chance of breakthrough.
洞真符	Talisman of Truth Comprehension
佩戴者可以提高潜力。	Increases the wearer's Potential.
真潜符	Latent Talisman
灵石墙	Spirit Stone Wall
木神鹤灯	Wood Crane Lantern
灵石置物台	Spirit Stone Display
火铜法座	Igneocopper Qi Cushion
玉石法座	Jade Qi Cushion
灵木法座	Spiritwood Qi Cushion
寒晶法座	Ice Crystal Qi Cushion
上古残骸	Ancient Remains
灵木置物台	Spiritwood Display
上古残木	Ancient Stump
灵木神鹤灯	Spiritwood Crane Lantern
灵石神鹤灯	Spirit Stone Crane Lantern
灵石丹炉	Spirit Stone Alchemy Furnace
灵石炼宝台	Spirit Stone Crafting Table
灵石护山剑阵	Spirit Stone Sword Shield
角色出生点	Born Point
逻辑点	Logic Point
烬灵傀儡·	Ember spirit puppet
傅文	Fuwen
傅	Fu
有	You
缑	Gou
翠萱	Cuixuan
？？？之奴	Slave of ???
雁诸	Yanpu
诸	Zhu
飞扬	Feiyang
闻人	Wenren
染云	Ranyun
解	Xie
刚	Gang
农泽	Nongze
农	Nong
伦	Lun
幸	Xing
咏	Yong
卢	Lu
羽倾	Yuqing
钟建	Zongjian
钟	Zhong
策	Ce
司徒	Situ
紫雅	Ziya
莫	Mo
和	He
造化金刚诀	
太上不坏咒	
燃魂无形	
朱雀流光诀	
蜀山落花真言	
赤月九极咒	
甲木天星神雷	
归真燃灵诀	
归真十二都天神雷	
南海甘霖诀	
凝光化伤诀	
牧辉真人落花诀	
冷月五气诀	
玉虚十二都天真言	
亢家震地诀	
千辛万苦，枉送性命。修行真的那么有意思么？竟让你们前赴后继。桀桀桀桀	You will die in a vain with all your efforts. Is cultivation so interesting that you come and die after another? HiaHiaHia
又有明界的食物送上门了！献上你的真灵，祭奠幽界的主宰罢！	Food from bright side is serving! Give your true spirit to the overload of Nether world!
饥渴之人	Hungry man
持续灵气损失	Continously lose Qi
此地传说是上古仙人布下的聚灵阵。他不断运转神通汲取周围灵气，万物衰败，自己也因承受不住而就此陨落，留下其残念还在持续不断地汲取灵气。	This place is a Qi Gathering formation created by an ancient god. He gathered surrounding Qi continously, which caused the crash of all things and himself. Only his thought is left to keeping gathering Qi here.
